M**DD*DD*DDEEED
ED****DDDBDDDDD
EDDBD*DDD*DDDDD
EDDDD*DBD*DDDDD
DDDDD*DDDBDDDDD
DDDDB*DDDDDDBDD
DDDDD*DDDDDDDDD
DEDDB*DDBD*DDED
DEEED*H*DDDEEED
DDDDDDDDDD*DDDD