MD*DD*DD*DDDDDD
*DDEDDDDDDDDDDD
*DDEDDDDDDDDDDD
*****DDDDDDEDDD
DDDE*DDDDDDDDDD
DDDE*DDDDDDDDDD
DDED**HDDDDDDDD
DDDDBDDDBD*DDDD
DEDDDDDDDDDDDDD
DDDDDBDDDD*DDDD